%%%%%%%%%%%%%%%%%%%%%%%%%%%%%%%%%%%%%
%                     %P.....       %
%                     %......       %
%                     %......       %
%                     %......       %
%                     %......       %
%                     %%%%%%.       %
%                          %.       %
%                          %.       %
%                          %.       %
%                          %.       %
%       ...................%.       %
%       .%%%%%%%%%%%%........       %
%       .%                          %
%       .%                          %
%       .%                          %
%       .%                          %
%       .%                          %
%       *%                          %
%%%%%%%%%%%%%%%%%%%%%%%%%%%%%%%%%%%%%